11 33
                           
S                               
---------            -----------
    H                  H        
    H                  H        
    H                  H        
-----------     -----------     
         H       H              
         H       H              
         H       H              
       -------------            